*******************************
*      *   *             *    *
*** * *** * * ***** *** * *** *
* * * * * *     * *   *       *
*     * * ***** * * *** ***** *
* * *       *     *   *       *
* *   * * *** *** *** *** *** *
*     * * *   *       * * * * *
***  ** * *** *** * * * * * * *
*       *       * * *       * *
* ****  *** *   *     *   * * *
*   *       *    L  * * * * * *
*   * * *     *       * *     *
*** * ****  *** * *** * ***** *
*       *     * *   * * * *   *
* *** *** * **  *** *** * * ***
*   *     *             *     *
*******************************
