*********************************
*      *   *             *      *
*** * *** * * ***** *** * ***   *
* * * * * *     * *   *     **  *
*     * * ***** * * *** *****   *
* * *       *     *   *    **  **
* ****  *** *   *     *   * *  **
*   *       *   **  * * * * *   *
*   * * *     *       * *      L*
*** * ****  *** * *** * *****   *
*       *     * *   * * * *     *
* *** *** * **  *** *** * * **  *
*   *     *       **    *   **  *
*********************************
